111111111111
100011000001
10001100P001
111111111111
