111111111111
100011C0E001
10001100P0E1
111111111111
