111111111111
100011000001
100011000001
111111111111
