111111101111
100011C00001
10001100P001
111111111111
